LEVEL 1
GRID 21 11
222222222222222222222
200000111111111111112
202020212121212121212
200000111111111111112
212121212121212121212
211111111111111111112
212121212121212121212
211111111111111111112
212121212121212121212
211111111111111111112
222222222222222222222
