LEVEL 1
GRID 21 11
222222222222222222222
200000001111111111112
202020202121212121212
200000101111111111112
212021202121212121212
211011101111111111112
212021202121212121212
211000001111111111112
212121212121212121212
211111111111111111102
222222222222222222222
FINISH 19 9
MONSTERS 6
SKELETON 3 1
SLIME 2 3
SPIDER 1 2
BAT 2 3
KNIGHT 2 3
GHOST 2 3
